1111111111
4     3  6
427  33  6
4    3   6
4        6
4     2726
4  3     6
4  3  7  6
4     2  6
5555555555
