1111111111
4  7     6
43       6
4    77326
4        6
4272     6
4  3     6
4  3  7  6
4     2  6
5555555555
